##########
#        #
#        #
# a    A #
###      #
###      #
# b    B #
#        #
#        #
##########

##########
#   ##  A#
#   ##   #
# a  B   #
#   ##  B#
#   ##   #
# b  A   #
#   ##   #
#   ##   #
##########

########
#      #
#      #
#      #
#      #
# x   X#
#      #
########